31 18
128 32
4
1 480 64
1 704 32
1 512 512
2 416 256
2 3 3 4 4 4 4 4 4 4 4 4 4 4 4 4 4 4 4 4 4 4 4 4 4 4 4 4 3 3 2
2 3 5 4 1 2 0 0 0 0 0 0 0 0 0 0 5 5 5 5 1 2 0 0 0 0 0 4 5 3 2
2 3 3 4 1 2 0 0 0 3 3 3 0 4 0 0 5 5 5 5 1 2 3 3 3 3 0 4 3 3 2
2 3 5 4 1 0 4 4 0 0 0 0 0 0 4 0 0 0 5 5 1 2 0 0 0 0 0 4 5 3 2
2 3 3 4 1 0 0 0 0 0 0 0 5 0 4 0 0 0 5 5 1 1 1 1 1 1 0 4 3 3 2
2 3 5 4 1 0 0 0 0 0 0 5 5 0 0 4 0 0 5 5 1 0 2 2 2 1 0 4 5 3 2
2 3 3 4 1 0 0 3 3 0 5 5 5 0 0 4 0 0 0 2 1 0 0 0 2 1 0 4 3 3 2
2 3 5 4 1 2 2 3 3 2 0 0 0 0 0 4 4 4 0 2 1 0 0 0 2 1 0 4 5 3 2
2 3 3 4 1 1 1 1 1 1 1 1 1 0 0 0 0 0 0 2 1 0 0 3 3 1 0 4 3 3 2
2 3 5 4 2 4 4 2 2 5 5 5 1 0 0 0 0 0 0 0 1 0 0 3 3 1 0 4 5 3 2
2 3 3 4 0 4 4 0 0 5 5 5 1 0 2 2 0 1 1 1 1 0 0 0 2 1 0 4 3 3 2
2 3 5 4 0 0 0 5 5 5 5 5 1 1 1 1 1 1 0 2 2 0 0 0 0 1 0 4 5 3 2
2 3 3 4 0 0 2 5 5 5 5 5 1 1 3 3 1 1 0 0 3 0 4 4 0 1 0 4 3 3 2
2 3 5 4 1 1 1 1 0 0 0 0 1 1 3 3 1 1 0 0 3 0 4 4 0 1 0 4 5 3 2
2 3 3 4 0 0 0 1 0 0 0 0 1 1 1 1 1 1 0 0 0 0 0 0 1 1 0 4 3 3 2
2 3 5 4 0 0 0 1 0 2 2 2 2 1 0 2 2 2 2 0 0 0 0 1 1 1 1 4 5 3 2
2 3 3 4 0 0 2 1 1 1 1 1 1 1 0 0 0 0 0 0 0 5 5 1 1 1 1 4 3 3 2
2 3 5 4 4 4 4 4 4 4 4 4 4 4 4 4 4 4 4 4 4 4 4 4 4 4 4 4 5 3 2