31 18
256 32
6
2 192 192
2 320 352
2 736 480
2 768 128
2 480 128
2 672 320
2 3 3 4 4 4 4 4 4 4 4 4 4 4 4 4 4 4 4 4 4 4 4 4 4 4 4 4 3 3 2
2 3 5 4 0 5 5 5 0 0 0 0 0 1 3 5 5 5 5 0 0 5 5 5 5 1 0 4 5 3 2
2 3 3 4 0 5 5 5 2 2 2 2 0 1 0 5 5 5 5 1 1 0 3 3 1 1 0 4 3 3 2
2 3 5 4 0 5 5 1 1 1 1 1 0 1 0 0 0 0 4 1 1 0 0 2 0 0 0 4 5 3 2
2 3 3 4 0 0 0 3 3 1 0 1 1 1 1 0 0 0 1 1 1 1 1 1 1 0 0 4 3 3 2
2 3 5 4 0 0 0 0 1 1 0 5 0 3 1 1 0 0 1 0 0 2 2 2 1 1 5 4 5 3 2
2 3 3 4 1 1 1 1 1 1 4 5 5 3 3 1 4 0 1 0 3 0 0 0 1 1 5 4 3 3 2
2 3 5 4 1 1 1 1 1 1 4 5 5 5 5 1 4 0 1 0 3 1 1 0 1 3 5 4 5 3 2
2 3 3 4 1 0 0 1 4 4 4 5 5 5 5 1 4 0 1 0 0 0 0 0 0 3 5 4 3 3 2
2 3 5 4 1 0 0 1 1 1 1 0 0 0 0 1 4 0 1 1 1 1 0 0 0 5 5 4 5 3 2
2 3 3 4 1 0 0 0 0 3 1 2 2 2 2 1 1 1 1 0 0 1 1 1 0 0 5 4 3 3 2
2 3 5 4 1 1 1 1 1 1 1 1 1 1 1 1 1 4 4 0 0 0 0 1 2 0 0 4 5 3 2
2 3 3 4 0 4 4 4 4 4 0 0 0 0 1 1 1 4 4 1 1 1 0 1 1 1 0 4 3 3 2
2 3 5 4 0 5 5 5 0 0 0 0 0 0 1 3 1 1 4 1 1 1 0 1 2 0 0 4 5 3 2
2 3 3 4 0 5 1 5 0 0 0 1 1 1 1 3 3 1 1 2 0 0 0 1 0 0 0 4 3 3 2
2 3 5 4 0 1 1 1 0 0 0 1 1 0 0 0 0 0 1 1 1 1 1 1 0 0 0 4 5 3 2
2 3 3 4 0 0 0 0 0 0 0 0 2 2 2 2 2 2 0 0 0 0 0 0 0 0 0 4 3 3 2
2 3 5 4 4 4 4 4 4 4 4 4 4 4 4 4 4 4 4 4 4 4 4 4 4 4 4 4 5 3 2

